############################################################
##...#.......#.#.......#.............#.........#...........#
##.#.#.#####.#.#.###.###.#########.#.#######.#.#####.###.#.#
##.#...#.....#.#.#.#...#.#.......#.#.........#.....#.#...#.#
##.#####.#####.#.#.###.#.#.#.#####.###############.###.###.#
##.#.....#.#...#.#...#...#.#.#.....#.......#.....#.#...#.#.#
##.#.#####.#.#.#.#.#.#####.#.#.###########.#.#.###.#.###.#.#
##.#.#...#...#...#.#.....#.#.#...#...#...#...#.......#.....#
##.#.#.#.#######.#.#####.###.###.#.#.#.#.#############.#####
##.#...#.......#.#.#...#.....#.#...#...#.#.......#...#...#.#
##.###########.#.#.#.#######.#.#########.#.#####.#.#.###.#.#
##.#.......#.#.#...#.......#...#.#.....#...#...#.#.#...#.#.#
##.#.#####.#.#.#########.#####.#.#.###.#####.#.#.#.###.#.#.#
##...#...#.#.#...#.....#...#...#...#.....#...#...#...#.#.#.#
######.#.#.#.###.#.###.#.#.#.#######.#####.#######.#.###.#.#
##.....#.#.#...#.#...#.#.#...#.......#...#.#...#...#.....#.#
##.#####.#.#.#.#.###.#.#.#######.#.###.#.#.#.###.#########.#
##.#.#...#.#.#.#.....#.#...#.....#.#...#...#.........#.....#
##.#.#.###.###.#######.###.###.#####.###############.#.###.#
##.#.....#...#.......#...#.....#...#.......#...#.......#...#
##.#.#######.#.#####.###.#######.#.###.###.#.#.#########.###
##.#.#...#...#.#...#.#.#..S#...#.#...#.#.#...#.......#.#.#.#
##.###.#.#.###.#.#.#.#.#####.#.#.###.#.#.#######.###.#.#.#.#
##.....#.#.#...#.#.#...#.....#...#.#.#.....#...#.#...#...#.#
##.#####.#.#.#.#.#####.#####.#####.#.#######.#.###.###.###.#
##.#...#...#.#.#.......#.....#.....#...#...#.#...#.#.#.#...#
##.#.#.#######.#.#######.#####.#.#####.#.#.#.###.#.#.#.#.#.#
##...#...#.....#.....#...#...#.#.#.....#.#...#...#.#.....#.#
########.#.#########.#.###.#.###.#.#####.#####.###.#######.#
##.....#...#.......#.#.#...#...#.#.#.....#.#...#.....#...#.#
####.#############.#.#.#.#####.#.#.###.###.#.#######.#.###.#
##...#...........#.#.#.....#...#.#.....#...#.#.......#.#...#
##.###.#.#######.#.#.#####.#.###.#######.###.###.#####.#.###
##.....#.#.#.....#.#...#...#.#.....#.........#...#.....#.#.#
##.#####.#.#.#####.###.#####.#.#.###.#########.#######.#.#.#
##...#.#.#...#.......#.....#.#.#...........#.........#.....#
####.#.#.#.#####.#########.#.###.#########.###.#####.#####.#
##.#...#.#.......#.....#...#...#.....#...#...#.....#...#.#.#
##.#.###.#######.#.#.#.#.###.#.#######.#.###.#########.#.#.#
##...#...#.......#.#.#.#.#...#.......#E#.#.....#.......#...#
##.###.###.#####.#.#.###.#.#########.#.#.#####.#.#######.###
##.#...#...#...#.#.#.....#.........#...#.....#...#.....#.#.#
##.#.#######.#.###.#######.#########.#######.#####.#####.#.#
##.#.........#.....#...#...#...#...#.#...#...#...#.......#.#
##.#################.#.#####.#.#.#.###.#.#.###.###.#######.#
##...................#.......#...#.....#...#...............#
############################################################
############################################################